Firs_Level
forest
20 10
02 01 01 01 01 01 02 02 01 01 02 01 01 01 01 01 02 02 01 01
01 01 01 01 01 01 01 01 01 01 01 01 01 01 01 01 01 01 01 01
01 01 01 01 02 01 01 01 01 01 01 01 01 01 02 01 01 01 01 01
01 01 01 01 01 02 02 02 01 01 01 01 01 01 01 02 02 02 01 01
02 01 01 01 01 01 01 01 01 01 02 01 01 01 01 01 01 01 01 01
02 01 01 01 01 01 01 01 01 01 02 01 01 01 01 01 01 01 01 01
02 01 01 01 01 01 01 01 01 01 02 01 01 01 01 01 01 01 01 01
02 01 01 01 01 01 01 01 01 01 02 01 01 01 01 01 01 01 01 01
02 01 01 01 01 01 01 01 01 01 02 01 01 01 01 01 01 01 01 01
02 01 01 01 01 01 01 01 01 01 02 01 01 01 01 01 01 01 01 01